rows 25
cols 33
players 2

m .................................
m ...........................$...$.
m ......................$..........
m ...........................$...$.
m ..................$...$..........
m ...........................$...$.
m ................$...$...$........
m .................................
m .................................
m ...............$...$...$.........
m .................................
m .................................
m ...............$...$...$.........
m .................................
m .................................
m .........................$.......
m .................................
m .................................
m .................................
m .................................
m .a...............................
m ..a...........................b..
m ...a.............................
m ....a.......................b....
m .................................
