rows 33
cols 37
players 2

powerup a 16 2 25 75 100 64
powerup a 16 35 25 75 100 64

powerup s 16 2 75 125 100 3
powerup s 16 35 75 125 100 3

powerup a 16 17 250 300 100 64
powerup s 16 21 350 400 100 4

m .....................................
m ..............b.b.b.b.b..............
m .....................................
m ..................b..................
m .....................................
m .....................................
m .....................................
m .....................................
m .$.................................$.
m .....................................
m .....................................
m .....................................
m ..$...............$...............$..
m .............$.........$.............
m .....................................
m .....................................
m ....$.......$.....$.....$.......$....
m .....................................
m .....................................
m .............$.........$.............
m ..$...............$...............$..
m .....................................
m .....................................
m .....................................
m .$.................................$.
m .....................................
m .....................................
m .....................................
m .....................................
m ..................a..................
m .....................................
m ..............a.a.a.a.a..............
m .....................................
