rows 32
cols 37
players 2

m .....................................
m ..................$..................
m .....................................
m .........$.................$.........
m ..................$..................
m ......$.......................$......
m ..........$...............$..........
m ..................$..................
m .....$.......$.........$.......$.....
m .....................................
m .....................................
m ..............$.......$..............
m .....................................
m .....................................
m ...............$.....$...............
m .....................................
m .....................................
m ................$...$................
m .....................................
m .....................................
m .....................................
m .....................................
m .....................................
m .a.................................b.
m ..a...............................b..
m ...a.............................b...
m ....a...........................b....
m .....a.........................b.....
m ......a.......................b......
m .......a.....................b.......
m ........a...................b........
m .....................................
