rows 25
cols 31
players 2

m ...............................
m .$.$.......................$.$.
m ...............................
m .$...........................$.
m ...............................
m ...............................
m ...............................
m ..............$.$..............
m ...............$...............
m ...............................
m ...............................
m ..........a.........b..........
m ........a...a..$..b...b........
m ..........a.........b..........
m ...............................
m ...............................
m ...............$...............
m ..............$.$..............
m ...............................
m ...............................
m ...............................
m .$...........................$.
m ...............................
m .$.$.......................$.$.
m ...............................
