rows 34
cols 34
players 2

m ..................................
m ......................a.a.a.a.....
m ..................................
m ..................................
m ..................................
m ................................b.
m ..................................
m ................................b.
m .....................$...$........
m ................................b.
m ..................................
m ................................b.
m .................$...$...$........
m ..................................
m ..................................
m ..................................
m .............$...$...$............
m ..................................
m ..................................
m ..................................
m .........$...$...$................
m ..................................
m ..................................
m ..................................
m .....$...$...$....................
m ..................................
m ..................................
m ..................................
m .$...$...$........................
m ..................................
m ..................................
m ..................................
m .$...$............................
m ..................................
