rows 33
cols 39
players 2

m .......................................
m ...................$...................
m ............$.............$............
m .......................................
m .......$.......................$.......
m .......................................
m .......................................
m ...................$...................
m ..............$.........$..............
m .......................................
m .......................................
m ...................$...................
m .......................................
m .......................................
m ....a.............................b....
m .......................................
m .b..a..............$..............b..a.
m .......................................
m ....a.............................b....
m .......................................
m .......................................
m ...................$...................
m .......................................
m .......................................
m ..............$.........$..............
m ...................$...................
m .......................................
m .......................................
m .......$.......................$.......
m .......................................
m ............$.............$............
m ...................$...................
m .......................................
