rows 43
cols 51
players 2
actions_per_turn 15


m ...................................................
m .$.............................b...........a.a.a...
m ................................................a..
m .................................................a.
m ....$..............................................
m ...................................................
m ...................................................
m .......$...........................................
m ...................................................
m ...................................................
m ..........$........................................
m ...................................................
m ...................................................
m .............$.....................................
m ...................................................
m ....................$..............................
m ................$..................................
m ...................................................
m .......................$...........................
m ...................................................
m ...................................................
m .....................$...$...$.....................
m ...................................................
m ...................................................
m ...........................$.......................
m ...................................................
m ..................................$................
m ..............................$....................
m ...................................................
m .....................................$.............
m ...................................................
m ...................................................
m ........................................$..........
m ...................................................
m ...................................................
m ...........................................$.......
m ...................................................
m ...................................................
m ..............................................$....
m .b.................................................
m ..b................................................
m ...b.b.b...........a.............................$.
m ...................................................