rows 33
cols 39
players 2

powerup a 16 17 50 100 100 64
powerup s 16 21 150 200 100 4

powerup a 16 17 250 300 100 64
powerup s 16 21 350 400 100 4

m .......................................
m ....................................b..
m .a.....................................
m .......................................
m .......................................
m ...................$...................
m .......................................
m .......................................
m .......................................
m .......................................
m ..........$.....$..$..$.....$..........
m .......................................
m .......................................
m ..............$.........$..............
m .......................................
m .......................................
m ............$......$......$............
m .......................................
m .......................................
m ..............$.........$..............
m .......................................
m .......................................
m ..........$.....$..$..$.....$..........
m .......................................
m .......................................
m .......................................
m .......................................
m ...................$...................
m .......................................
m .......................................
m .b.....................................
m ....................................a..
m .......................................
