rows 33
cols 41
players 2

m .........................................
m .$..................$..................$.
m ...............$.........$...............
m .........................................
m .........................................
m .........................................
m .........................................
m .........................................
m .........................................
m .........................................
m .........................................
m .........................................
m ..$...............a...b...............$..
m .........................................
m ...............b.........a...............
m .........................................
m .$..........$.......$.......$..........$.
m .........................................
m ...............a.........b...............
m .........................................
m ..$...............b...a...............$..
m .........................................
m .........................................
m .........................................
m .........................................
m .........................................
m .........................................
m .........................................
m .........................................
m .........................................
m ...............$.........$...............
m .$..................$..................$.
m .........................................
