rows 29
cols 35
players 2

m ...................................
m ..............$..$...............b.
m .a.................................
m .................$...............b.
m .a.................................
m .................$...............b.
m .a.................................
m .................$...............b.
m .a.................................
m .................$...............b.
m .a.................................
m .................$...............b.
m .a.............$...................
m ................$................b.
m .................$.................
m .a................$................
m ...................$.............b.
m .a...............$.................
m .................................b.
m .a...............$.................
m .................................b.
m .a...............$.................
m .................................b.
m .a...............$.................
m .................................b.
m .a...............$.................
m .................................b.
m .a...............$..$..............
m ...................................
