rows 24
cols 33
players 2

m .................................
m .b..............$..............a.
m ............$.......$............
m .................................
m .................................
m .........$.............$.........
m .............$.....$.............
m .................................
m ........$...............$........
m .................................
m .................................
m .........$...$.....$...$.........
m ...............$.$...............
m .................................
m ............$.......$............
m ................$................
m .................................
m .................................
m .................................
m .................................
m .a.............................b.
m ..a...........................b..
m ...a.........................b...
m .................................
