rows 24
cols 33
players 2
maxpoints 1


m .................................
m ........a.......$.......a........
m .................................
m .................................
m ........a.......a.......a........
m .................................
m .................................
m .................................
m .................................
m .................................
m .................................
m .................................
m .................................
m .................................
m .................................
m .................................
m .................................
m .................................
m .................................
m .................................
m .................................
m .................................
m ........b.......b.......b........
m .................................
