rows 39
cols 45
players 2
powerup r 10 5 20 120 100
powerup r 28 39 20 120 100

m .............................................
m ........a.....................b.b.b.b........
m .............................................
m .............................................
m .............................................
m .............................................
m ...$.........................................
m .............................................
m .............................................
m .............................................
m .............................................
m .............................................
m ........$.............................$......
m ...................$.........................
m ..........................$..................
m .............................................
m .$....................$......................
m .............................................
m .............................................
m .$................$...$...$................$.
m .............................................
m .............................................
m ......................$....................$.
m ..................$..........................
m .............................................
m .........................$...................
m .............................................
m ......$.............................$........
m .............................................
m .............................................
m .............................................
m .............................................
m .........................................$...
m .............................................
m .............................................
m .............................................
m .............................................
m ........a.a.a.a.....................b........
m .............................................