rows 25
cols 33
players 2

m .................................
m ....a............................
m ...a.............................
m ..a..............................
m .a...............................
m .................................
m .................................
m .................................
m ................$...$...$...$....
m .................................
m ..............$.......$...$...$..
m .................................
m .............$.......$.....$...$.
m .................................
m ..............$.......$...$...$..
m .................................
m ................$...$...$...$....
m .................................
m .................................
m .................................
m .b...............................
m ..b..............................
m ...b.............................
m ....b............................
m .................................
