rows 33
cols 39
players 2

treasure 0 1
treasure 1 1
treasure 2 1
treasure 3 1
treasure 4 1
treasure 5 1
treasure 6 1
treasure 7 1
treasure 7 3

m .......................................
m ..a.................................b..
m .a...................................b.
m .......................................
m .......................................
m .......................................
m .......................................
m .......................................
m .......................................
m .......................................
m ...................$...................
m ................$.....$................
m .......................................
m .............$.....$.....$.............
m .......................................
m .......................................
m ............$...$..$..$...$............
m .......................................
m .......................................
m .............$.....$.....$.............
m .......................................
m ................$.....$................
m ...................$...................
m .......................................
m .......................................
m .......................................
m .......................................
m .......................................
m .......................................
m .......................................
m .b...................................a.
m ..b.................................a..
m .......................................
