rows 17
cols 17
players 2
maxpoints 7
actions_per_turn 2

m .................
m ..............a..
m .b...............
m .................
m ........$........
m .................
m ......$.$.$......
m .................
m ....$.$.$.$.$....
m .................
m ......$.$.$......
m .................
m ........$........
m .................
m ...............b.
m ..a..............
m .................
